1111111111
1010000001
1011111001
1000000001
1000000001
1000011001
1000011001
1000000001
1011111101
1000000001
1001111101
1000010001
1001110$01
1001110001
1111111111