111111111111111
100001100011001
100000000011001
100001100011001
100001100011001
100000000000001
100001100011001
100001100011001
100001100011001
100111111000001
100001100011001
100001100011001
10000110$000001
100001100011001
111111111111111